16 16 16 16 20 21 16 16 16 16 16
17 17 17 17 18 19 17 17 17 17 17
2 0 0 0 0 0 0 0 0 0 2
2 0 0 0 0 0 0 0 0 0 2
2 0 0 0 0 0 0 0 0 0 2
2 0 0 0 0 0 0 0 0 0 2