16 16 16 16 16 16 16 16 16 16 16 16 16 16 16 16 16 16 16 16 16 16 16 16 16 16 16 16 16 16 16 16 16 16 16 16 16 16 16 16 16 16 16 16 16 16 16 16 16 16 16 16 16 16 16 16 16 16 16 16 16 16 16 16 16 16 16 16 16 16 16 16 16 16 16 16 16 16 16 16
16 16 16 16 16 16 16 20 21 16 16 16 16 16 16 16 16 16 16 16 16 16 16 16 16 16 16 16 16 16 16 16 16 16 16 16 16 16 16 16 16 16 16 16 16 16 16 16 16 16 16 16 16 16 16 16 16 16 16 16 16 16 16 16 16 16 16 16 16 16 16 16 16 16 16 16 16 16 16 16
17 17 17 17 17 17 17 18 19 17 17 17 17 17 17 17 17 17 17 17 17 17 17 17 17 17 17 17 17 17 17 17 17 17 17 17 17 17 17 17 17 17 17 17 17 17 17 17 17 17 17 17 17 17 17 17 17 17 17 17 17 17 17 17 17 17 17 17 17 17 17 17 17 17 17 17 17 17 17 17
2 0 0 0 0 0 0 0 0 0 0 0 0 0 0 0 0 0 0 0 0 0 2 2 0 0 0 0 0 0 0 0 0 0 0 0 0 0 0 2 0 0 0 0 0 0 2 2 0 0 0 0 0 0 0 0 0 0 0 2 0 0 0 0 0 0 0 0 0 0 0 0 0 0 0 0 0 0 0 2
2 0 0 0 0 0 0 0 0 0 0 0 0 0 0 0 0 0 0 0 0 0 2 2 0 0 0 0 0 0 0 0 0 0 0 0 0 0 0 2 0 0 0 0 0 0 2 2 0 0 0 0 0 0 0 0 0 0 0 0 0 0 0 0 0 0 0 0 0 0 0 0 0 0 0 0 0 0 0 2
2 0 0 0 0 0 0 0 0 0 0 0 0 0 0 0 0 0 0 0 0 0 2 2 0 0 0 0 0 0 0 0 0 0 0 0 0 0 0 2 0 0 0 0 0 0 2 2 0 0 0 0 0 0 0 0 0 2 0 0 0 0 0 0 0 0 0 0 0 0 0 0 0 0 0 0 0 0 0 2
23 7 8 7 8 7 8 7 8 7 8 7 8 7 13 12 0 0 0 0 2 2 0 0 0 0 0 14 15 7 8 7 8 7 8 7 13 12 0 0 0 0 2 2 0 0 0 0 0 14 15 7 8 7 8 7 8 7 13 12 0 0 0 2 0 0 0 0 0 0 0 0 0 0 0 0 0 0 0 2
1 1 1 1 1 1 1 1 1 1 1 1 1 1 1 1 10 0 0 0 0 2 2 0 0 0 0 0 11 1 1 1 1 1 1 1 1 1 1 10 0 0 0 0 2 2 0 0 0 0 0 11 1 1 1 1 1 1 1 1 1 1 10 0 0 0 0 0 0 0 0 0 0 0 0 0 0 0 0 2
1 1 1 1 1 1 1 1 1 1 1 1 1 1 1 1 10 0 0 0 0 2 2 0 0 0 0 0 11 1 1 1 1 1 1 1 1 1 1 10 0 0 0 0 2 2 0 0 0 0 0 11 1 1 1 1 1 1 1 1 1 1 10 0 0 0 0 0 0 0 0 0 0 0 0 0 0 0 0 2
1 1 1 1 1 1 1 1 1 1 1 1 1 1 1 1 10 0 0 0 0 2 2 0 0 0 0 0 11 1 1 1 1 1 1 1 1 1 1 10 0 0 0 0 2 2 0 0 0 0 2 11 1 1 1 1 1 1 1 1 1 1 10 0 0 0 0 0 0 0 0 0 0 0 0 0 0 0 0 2
1 1 1 1 1 1 1 1 1 1 1 1 1 1 1 1 10 0 0 0 0 2 2 0 0 0 0 0 11 1 1 1 1 1 1 1 1 1 1 10 0 0 0 0 2 2 0 0 0 0 0 11 1 1 1 1 1 1 1 1 1 1 10 0 0 0 0 0 0 0 0 0 0 0 0 0 0 0 0 2
1 1 1 1 1 1 1 1 1 1 1 1 1 1 1 1 10 0 0 0 0 2 2 0 0 0 0 0 11 1 1 1 1 1 1 1 1 1 1 10 0 0 0 0 2 2 0 0 0 0 0 11 1 1 1 1 1 1 1 1 1 1 10 0 0 0 0 0 0 0 0 0 0 0 0 0 0 0 0 2
9 9 9 9 9 9 9 6 1 1 1 1 1 1 1 1 10 0 0 0 0 2 2 0 0 0 0 0 11 1 1 1 1 1 1 1 1 1 1 10 0 0 0 0 2 2 0 0 0 0 0 11 1 1 1 1 1 1 1 1 1 1 10 0 2 0 0 0 0 0 0 0 0 0 0 0 0 0 0 2
0 0 0 0 0 0 0 11 1 1 1 1 1 1 1 1 10 0 0 0 0 2 2 0 0 0 0 0 11 1 1 1 1 1 1 1 1 1 1 10 0 0 0 0 2 2 0 0 0 0 0 11 1 1 1 1 1 1 1 1 1 1 10 0 0 0 0 0 0 0 0 0 0 0 0 0 2 0 0 2
0 0 0 0 0 0 0 11 1 1 1 1 1 1 1 1 10 0 0 0 0 2 2 0 0 0 0 0 11 1 1 1 1 1 1 1 1 1 1 10 0 0 0 0 2 2 0 0 0 0 0 11 1 1 1 1 1 1 1 1 1 1 10 0 0 0 0 0 0 0 0 0 0 0 0 0 0 0 0 2
2 0 0 0 0 0 0 11 1 1 1 1 1 1 1 1 10 0 0 0 0 2 2 0 0 0 0 0 11 1 1 1 1 1 1 1 1 1 1 10 0 0 0 0 2 2 0 0 0 0 0 11 1 1 1 1 1 1 1 1 1 1 10 0 0 0 0 0 0 0 0 0 0 0 0 0 0 0 0 2
0 0 0 0 0 0 2 11 1 1 1 1 1 1 1 1 10 0 0 0 0 2 2 0 0 0 0 0 11 1 1 1 1 1 1 1 1 1 1 10 0 0 0 0 2 2 0 0 0 0 0 11 1 1 1 1 1 1 1 1 1 1 10 0 0 0 0 0 0 0 0 0 0 0 0 0 0 0 0 2
0 0 0 0 0 0 0 11 1 1 1 1 1 1 1 1 10 0 0 0 0 2 2 0 0 0 0 0 11 1 1 1 1 1 1 1 1 1 1 10 0 0 0 0 2 2 0 0 0 0 0 11 1 1 1 1 1 1 1 1 1 1 10 0 0 0 0 0 0 0 2 0 0 0 0 0 0 0 0 2
0 0 0 0 0 0 0 11 1 1 1 1 1 1 1 1 10 0 0 0 0 2 2 0 0 0 0 0 11 1 1 1 1 1 1 1 1 1 1 10 0 0 0 0 2 2 0 0 0 0 0 11 1 1 1 1 1 1 1 1 1 1 10 0 0 0 0 0 0 0 0 0 0 0 0 0 0 0 0 2
0 0 0 0 0 0 0 11 1 1 1 1 1 1 1 1 10 0 0 0 0 2 2 0 0 0 0 0 11 1 1 1 1 1 1 1 1 1 1 10 0 0 0 0 2 2 0 0 0 0 0 11 1 1 1 1 1 1 1 1 1 1 10 0 0 0 0 0 0 0 0 0 0 0 0 0 0 0 0 2
0 0 0 2 0 0 0 11 1 1 1 1 1 1 1 1 10 0 0 0 0 2 2 0 0 0 0 0 11 1 1 1 1 1 1 1 1 1 1 10 0 0 0 0 2 2 0 0 0 0 0 11 1 1 1 1 1 1 1 1 1 1 10 0 0 0 0 0 0 0 0 0 0 0 0 0 0 0 0 2
0 0 0 0 0 0 0 11 1 1 1 1 1 1 1 1 10 0 0 0 0 2 2 0 0 0 0 0 11 1 1 1 1 1 1 1 1 1 1 10 0 0 0 0 2 2 0 0 0 0 0 11 1 1 1 1 1 1 1 1 1 1 10 0 0 0 2 0 0 0 0 0 0 0 0 0 0 0 0 2
0 0 0 0 0 0 0 11 1 1 1 1 1 1 1 1 10 0 0 0 0 2 2 0 0 0 0 0 11 1 1 1 1 1 1 1 1 1 1 10 0 0 0 0 2 2 0 0 0 0 0 11 1 1 1 1 1 1 1 1 1 1 10 0 0 0 0 0 0 0 0 0 0 0 0 0 0 0 0 2
0 0 0 0 0 0 0 11 1 1 1 1 1 1 1 1 10 0 0 0 0 2 2 0 0 0 0 0 11 1 1 1 1 1 1 1 1 1 1 10 0 0 0 0 2 2 0 0 0 0 0 11 1 1 1 1 1 1 1 1 1 1 10 0 0 0 0 0 0 0 0 0 0 0 0 0 0 0 0 2
7 23 7 8 7 8 7 4 1 1 1 1 1 1 1 1 10 0 0 0 0 2 2 0 0 0 0 0 11 1 1 1 1 1 1 1 1 1 1 10 0 0 0 0 2 2 0 0 0 0 0 11 1 1 1 1 1 1 1 1 1 1 10 0 0 0 0 0 0 0 0 0 0 0 0 0 0 0 0 2
1 1 1 1 1 1 1 1 1 1 1 1 1 1 1 1 10 0 0 0 0 0 0 0 0 0 0 0 11 1 1 1 1 1 1 1 1 1 1 10 0 0 0 0 0 0 0 0 0 0 0 11 1 1 1 1 1 1 1 1 1 1 10 0 0 0 0 0 0 0 0 0 0 0 0 0 0 0 0 2
1 1 1 1 1 1 1 1 1 1 1 1 1 1 1 1 3 7 8 7 8 7 8 7 8 7 8 7 4 1 1 1 1 1 1 1 1 1 1 1 3 7 8 7 8 7 8 7 8 7 8 7 4 1 1 1 1 1 1 1 1 1 1 3 7 7 8 7 8 7 8 7 8 7 8 7 8 7 8 23
1 1 1 1 1 1 1 1 1 1 1 1 1 1 1 1 1 1 1 1 1 1 1 1 1 1 1 1 1 1 1 1 1 1 1 1 1 1 1 1 1 1 1 1 1 1 1 1 1 1 1 1 1 1 1 1 1 1 1 1 1 1 1 1 1 1 1 1 1 1 1 1 1 1 1 1 1 1 1 1
1 1 1 1 1 1 1 1 1 1 1 1 1 1 1 1 1 1 1 1 1 1 1 1 1 1 1 1 1 1 1 1 1 1 1 1 1 1 1 1 1 1 1 1 1 1 1 1 1 1 1 1 1 1 1 1 1 1 1 1 1 1 1 1 1 1 1 1 1 1 1 1 1 1 1 1 1 1 1 1
1 1 1 1 1 1 1 1 1 1 1 1 1 1 1 1 1 1 1 1 1 1 1 1 1 1 1 1 1 1 1 1 1 1 1 1 1 1 1 1 1 1 1 1 1 1 1 1 1 1 1 1 1 1 1 1 1 1 1 1 1 1 1 1 1 1 1 1 1 1 1 1 1 1 1 1 1 1 1 1